
NO textures/Mona_Lisa.png
SO textures/Sunflowers.png
WE textures/the_starry_night.png
EA textures/girl_with_a_pearl_earring.png


C 0,20,60
F 60,129,11

        1111111111111111111111111
        10000000001110000000000001
        10110000011 10000000000001
        100100000001000000N000001
111111111011000001110000000000001
100000000011000001110111111111111
11110111111111011100000010001
11110111111111011101010010001
11000000110101011100000010001
10000000000000001100000010001
10000000000000001101010010001
1100000111010101111101111000111
11110111 10110101 11111010001
11111111 1111111 111111111111