NO ./the_north_texture
SO ./the_south_texture
WE ./the_west_texture
EA ./the_east_texture

F 220,100,0 
C 225,30,0

1111111111111111111111111
1000000000110000000000001
1011000000N00000000000001
1001000000000000000000001
1111111110000000011100001
1000000000000000011101111
1111011111001101110000001
1111011111001101110101001
1100000011000101110000001
1000000000000000110000001
1000000000000000110101001
1100000111000101111101111
11100111 1000101 10111101
11111111 1111111 11111111