NO ./the_north_texture
SO ./the_south_texture
WE ./the_west_texture
EA ./the_east_texture
F 220,100,0
C 225,30,0

1111111111111111111111111
1000000000110000000000001
1011000001110000000000001
100100000000000000000000111111111
111111111011000001110000000000001
100000000011000001110111111111111
11110111111111011100000010001
11110111111111011101010010001
11000000110101011100000010001
10000000000000001100000010001
10000000000000001101010010001
1100000111010101111101111000111
11100111 1110101 101111010001
11101111 1111111 111111111111
11101
10001
1N001
10001
11111