NO textures/no.xpm
SO textures/so.xpm
WE textures/we.xpm
EA textures/ea.xpm
F 220,100,0
C 225,30,0

11111111111111111111111111
11000000001100000000000011
1011000001110S000000000011
10010000000000000000000011
11111111111111111111111111