
NO textures/wall.png
SO textures/flag.png
WE textures/hitler.png
EA textures/gray_wall.png

C 5,0,33
F 60,19,11


11111111111111111111111111
10000000001100000000000001
10110000011100000100000011
10010000000000001000000011
11111000000110000011100001
10000000000000110000011101
11110001111000001100000011
11110000000000001110101001
11000000110101011100000011
10000000000000001100000011
10000N00000000001101010011
11111111111111111111111111