NO textures/no.xpm
SO textures/so.xpm
WE textures/we.xpm
EA textures/ea.xpm
F 220,100,0
C 225,30,0

11111111111111111111111111
100000000011000S0000000011
10110000011100000000000011
10010000000000000000000011
11111111101100000111000011
10000000001100000111011111
11110111111111011100000011
11110111111111011101010011
11000000110101011100000011
10000000000000001100000011
10000000000000001101010011
11000001110101011111010011111
11110111 1110101 1011110000001
11111111 1111111 1111111111111