
NO textures/gray_wall.png
SO textures/gray_wall.png
WE textures/gray_wall.png
EA textures/flag.png

C 0,0,33
F 60,179,110


111111111111111111111111111
100000000011000E0000000011
10110000011100000100000011
10010000000000001000000011
11111111101100000111000011
10000000001100000111011111
11110111111111011100000011
1111011111111101110101001
11000000110101011100000011
10000000000000001100000011
10000000000000001101010011
11000001110101011111010011
 11111111111111111111111111