NO textures/Mona_Lisa.png
SO textures/Sunflowers.png
WE textures/the_starry_night.png
EA textures/girl_with_a_pearl_earring.png

C 0,0,33
F 60,179,110


111111111111111111111111111
100000000011000E0000000011
10110000011100000000000011
10010000000000001000000011
1111111110110000111000011
10000000001100000111011111
11110111111101011100000011
11110111100001101110101001
11110111100001101110101001
11110111100001101110101001
11110111100001101110101001
11110111100001101110101001
11110111100001101110101001
11110111100001101110101001
11110111100001101110101001
11000001110101011111010011
 11111111111111111111111111